11030110000000
10011100011110
10000000100000
11004110001110
00001111101030
01111030100010
00000000001000
10001111400011
11011000001000
10000011101101
10020000000000
10000111000114