1111111111
1000000001
1011111101
1010030101
1010111101
1010100001
1010001041
1011111001
1000021001
1111111111
