1111111111
1000000041
1210000101
1011001101
1000000301
1011001101
1011001101
1010030101
1000110001
1111111111